type octile
height 14
width 25
map
...@....@....@..........@
...@....@....@..........@
...@....@.@@@@@@@@@@....@
........@....@.....@....@
@@......@....@.....@....@
........@...@@....@@....@
@@@..@@@@@..@@....@@....@
@@...........@@...@@@..@@
@@...........@...........
@@...........@@@@@.......
@@.......................
@@@.@@@..@..............@
....@....@..@.....@@@...@
....@....@..@.....@@@....