type octile
height 17
width 17
map
@@@@@@@@@@@@@@@@@
@.........@.@...@
@.@@@@@@@.@.@@@.@
@...@.@.........@
@.@@@.@@@.@@@@@@@
@.....@.@.@.....@
@.@@@@@.@@@.@.@@@
@...........@...@
@.@@@.@@@.@@@.@@@
@.@.@...@.@.....@
@.@.@.@.@@@@@@@.@
@...@.@.@.@.@...@
@.@@@@@@@.@.@@@.@
@...........@.@.@
@.@@@.@@@.@@@.@@@
@...@...@.......@
@@@@@@@@@@@@@@@@@